Bill Ackman's: Pershing Square Capital Management
Louis Bacon's: Moore Capital Management
Kyle Bass's: Hayman Capital Management
Bruce Berkowitz's: Fairholme Capital Management
Warren Buffett's: Berkshire Hathaway
Steven Cohen's: Point72 Asset Management
Chase Coleman's: Tiger Global Management
Ray Dalio's: Bridgewater Associates
David Einhorn's: Greenlight Capital
Jeremy Grantham's: Grantham Mayo Van Otterloo
Joel Greenblatt's: Gotham Asset Management
Ken Griffin's: Citadel Advisors
Andreas Halvorsen's: Viking Global Investors
Carl Icahn: Icahn Carl C
Seth Klarman's: Baupost Group
Daniel Loeb's: Third Point
Howard Marks's: Oaktree Capital Management
Victor Mashaal's: Rima Senvest Management
John Paulson's: Paulson & Co.
Nelson Peltz's: Trian Fund Management
Larry Robbins's: Glenview Capital Management
Wilbur Ross's: Invesco Private Capital
Barry Rosenstein's: Jana Partners
Jim Simons's: Renaissance Technologies
Paul Singer's: Elliott Management Corp
George Soros's: Soros Fund Management
Brian Taylor's: Pine River Capital Management
David Tepper's: Appaloosa Management
Prem Watsa's: Fairfax Financial Holdings
TIAA
Blackrock